##########
#........#
#.####...#
#....#...#
#....#...#
#........#
##########