##########
#........#
#.######.#
#.#....#.#
#.#.##.#.#
#.#......#
#.######.#
#........#
##########